##################
#................#
#................#
#................#
#.......#####....#
#...........#....#
#...........#....#
##################